???
person : 人
bicycle : 自行车
car : 汽车
motorcycle : 摩托车
airplane : 飞机
bus : 公交车
train : 火车
truck : 卡车
boat : 船
traffic light : 交通等灯
fire hydrant : 消火栓
???
stop sign : 停止信号
parking meter : 停车收费器
bench : 长椅
bird : 鸟
cat : 猫
dog : 狗
horse : 马
sheep : 羊
cow : 牛
elephant : 大象
bear : 熊
zebra : 斑马
giraffe : 长颈鹿
???
backpack : 背包
umbrella : 伞
???
???
handbag : 手提包
tie : 领带
suitcase : 手提箱
frisbee : 飞碟
skis : 滑雪板
snowboard : 滑雪板
sports ball : 球
kite : 风筝
baseball bat : 棒球棒
baseball glove : 高尔夫球棒
skateboard : 滑板
surfboard : 冲浪板
tennis racket : 网球拍
bottle : 瓶子
???
wine glass : 酒瓶
cup : 杯子
fork : 餐叉
knife : 刀
spoon : 勺子
bowl : 碗
banana : 香蕉
apple : 苹果
sandwich : 三明治
orange : 桔子
broccoli : 西兰花
carrot : 胡萝卜
hot dog : 热狗
pizza : 披萨
donut : 油炸面包圈
cake : 蛋糕
chair : 椅子
couch : 卧榻
potted plant : 盆栽植物
bed : 床
???
dining table : 餐桌
???
???
toilet : 厕所
???
tv : 电视
laptop : 笔记本电脑
mouse : 鼠标
remote : 遥控器
keyboard : 键盘
cell phone : 电话
microwave : 微波炉
oven : 烤箱
toaster : 烤面包片器
sink : 洗碗槽
refrigerator : 冰箱
???
book : 书
clock : 闹钟
vase : 花瓶
scissors : 剪刀
teddy bear : 玩具熊
hair drier : 吹风机
toothbrush : 牙刷
